Audio File	Transcription
enus_ruru_0.mp3	Однако полиция не захотела выносить Сорли из избы и дело замяли.
enus_ruru_1.mp3	конечно далеко не со всеми складывались дружеские отношения но если случались какие то конфликты обиды старались не выносить ссор из избы в крайнем случае просто менялись столиками чтобы не сидеть рядом
enus_ruru_2.mp3	и тут без вопросов каждый из них поддался на эту ее зрительную провокацию и каждый из них готов выпрыгнуть из штанов чтобы ее не только удивить а потрясти в изумлении
enus_ruru_3.mp3	Если девушка действительно нравится, мужчина выпрыгнут из штанов, но найдет возможность пригласить ее на свидание. Было бы желание.
enus_ruru_4.mp3	в результате всё строится на высосанной из пальца гипотезе а не на почве реальной действительности
enus_ruru_5.mp3	согласитесь, гораздо интереснее бывшего человека послушать, чем читать повести, высосанные из пальца автором, никогда не встававшим из своего писательского кресла
enus_ruru_6.mp3	Редактор, директор галереи, заказчики. Мама полчаса трепала нервы, допрашивая меня с пристрастием.
enus_ruru_7.mp3	потому что если вы понимаете что вы не можете помочь человеку то проще ему отказать чем взять деньги а потом ругаться и возвращать их и трепать нервы друг другу
enus_ruru_8.mp3	Может быть, вы напрасно ищете причину в психологической области, а собака зарита именно там.
enus_ruru_9.mp3	вот где собака зарита перебил меня бармен а говоришь счастлив как можно быть счастливым когда тебе отказывает издательство
enus_ruru_10.mp3	Мое мнение никто и никогда не спрашивал, так что у меня от удивления глаза на лоб полезли, но я с важным видом сунула ложку в рот.
enus_ruru_11.mp3	У разбойника глаза на лоб полезли, настолько он был удивлен.
enus_ruru_12.mp3	У него просто глаза разбегались от изобилия и разнообразия товаров.
enus_ruru_13.mp3	Так я попала на утренний базар, где глаза расбегались от обилия деликатесов.
enus_ruru_14.mp3	Вам даже в голову не придет позволить некоторым людям заботиться о ваших детях, но есть и те, кому глазом не моргнув можно доверить свою жизнь.
enus_ruru_15.mp3	в следующий раз он и глазом не моргнув попрятал по карманам деньги из госбюджета выделенные на обеды сельским школьникам
enus_ruru_16.mp3	 А что, если я глух, как Тетерев? Вот, исправка имеется.
enus_ruru_17.mp3	Она глухая, как тетерев. Между прочим, замечательная женщина.
enus_ruru_18.mp3	Иван с Ольгой друг друга не понимали, как будто говорили на разных языках.
enus_ruru_19.mp3	 Мама, мы с тобой говорим на разных языках. Ты мне про одно, я тебе про другое.
enus_ruru_20.mp3	доченька зачем тебе выходить за него замуж он же гол как сокол у него ничего нет как же вы будете жить
enus_ruru_21.mp3	Мало того, что голый, как сокол, так еще и страшный.
enus_ruru_22.mp3	Для того, чтобы грести под себя, для того, чтобы хавать, чтобы лгать, не надо разбираться в физике, в литературе, в истории.
enus_ruru_23.mp3	 Ну да. Мы с тобой два сапога пара.  охотно согласился Шурик.
enus_ruru_24.mp3	Удивительно, как ты крепко спишь, ничего не слышишь, и бабушка тоже. Два сапога пара.
enus_ruru_25.mp3	Но прошло несколько дней, и я понял, что сделал из мухи слона.
enus_ruru_26.mp3	Я, наверное, сделала из мухи слона. Слишком много стереотипов у меня в голове.
enus_ruru_27.mp3	"Напиши только ""Денмарк"" красивыми буквами и дело в шляпе."
enus_ruru_28.mp3	У него были диктаторские замашки, и свое учреждение он держал в ежовых рукавицах.
enus_ruru_29.mp3	а жизнь то в ежовых рукавицах людей держит.
enus_ruru_30.mp3	герцог аристократ до мозга костей был так же как и они шокирован тем что убийцу знатного рода ждет та же смерть что и у преступника плебея
enus_ruru_31.mp3	Вы очень красивые и сильные. Кровь сейчас остановится, а щека до свадьбы заживет.
enus_ruru_32.mp3	потому что всякий уважающий себя младший брат считает своим долгом доводить до белого коления старшую сестру
enus_ruru_33.mp3	 Ох, зря это она! Неужели не знает, что мужчин нельзя провоцировать, а тем более доводить до белого коления?
enus_ruru_34.mp3	Мама часто драла сына как сидорову козу за плохие оценки в школе.
enus_ruru_35.mp3	 Не нужно нарушать правила в нашем обществе, иначе тебя будут драть, как сидорову козу.
enus_ruru_36.mp3	Остатки ты раздал своим бездельникам, а лаборатория, которая заработала премию, получила дырку от бублика.
enus_ruru_37.mp3	то есть возраст у него категорически отсутствовал уверено у него и в паспорте в строке дата рождения вместо цифр стоит дырка от бублика
enus_ruru_38.mp3	Советская власть была еще жива, но уже дышала на ладан.
enus_ruru_39.mp3	К тому времени компания уже фактически дышала на ладан, поскольку ее долгосрочные долговые обязательства выросли до 7,6 млрд. долларов.
enus_ruru_40.mp3	смотри алексей как бы наш железный конь не откинул копыты раньше срока дмитрий петрович неодобрительно посмотрел на своего беспечного водителя заливать такую соляру без специальных присадок в современный дизельный двигатель очень опасно
enus_ruru_41.mp3	если этой зимой опять случится такой сильный мороз то половина яблонь в нашем саду точно откинет копыта вымерзнет совсем надо было не слушать тебя а руинированные сорта покупать
enus_ruru_42.mp3	Ему ничего не стоило поливать ее грязью за спиной. Зачем нужны такие отношения?
enus_ruru_43.mp3	Вместо того, чтобы поливать грязью идею конкурентов, лучше бы грамотно изложил свои идеи.
enus_ruru_44.mp3	следователь пригрозил подозреваемому, что если тот будет качать право, получит срок как два пальца об асфальт.
enus_ruru_45.mp3	Казалось, что найти выход из этой ситуации очень просто  как два пальца об асфальт. Но не тут-то было.
enus_ruru_46.mp3	 Как пить дать, нас замечат,  сказал Гоша.  Ни каркой не замечат. Мы осторожно,  ответил Петя.
enus_ruru_47.mp3	как пить дать придется еще несколько дней потратить, чтобы закончить эту работу
enus_ruru_48.mp3	Жили они с родителями, как у Христа за пазухой, пока жена не захотела съехать.
enus_ruru_49.mp3	Ты посмотри на него, устроился, как у Христа, за пазухой и еще чем-то недоволен.
enus_ruru_50.mp3	Она хотела ему еще так многое сказать, но, как говорят, поезд ушел. Надо было раньше думать.
enus_ruru_51.mp3	Марина считала, что ее поезд давно ушел и ничего нового и интересного в жизни ее уже не случится.
enus_ruru_52.mp3	 Поживем, увидим, чем все это закончится,  сказала спокойным тоном бабушка и пошла заваривать чай.
enus_ruru_53.mp3	Никогда не знаешь, что будет дальше. Поэтому поживем, увидим. Не будем загадывать вперед.
enus_ruru_54.mp3	Давно пора объединяться со Спейкс и создавать реальную станцию, а не витать в облаках фантастических проектов.
enus_ruru_55.mp3	димко уничтожен а следовательно вновь завоеван и покорен теперь она из него будет вить веревки сделает своим верным рабом вместо попова
enus_ruru_56.mp3	скоро ты научишься вить веревки из мужчин но они уже сейчас прекрасно знают как манипулировать нами
enus_ruru_57.mp3	 Нечего во всю Ивановскую арать, чего дома есть, а чего нет?
enus_ruru_58.mp3	 А у тебя все окна горят, как на празднике, музыка во всю Ивановскую и в окнах танцующие тени.
enus_ruru_59.mp3	Учитель всегда говорил нам, что нужно учить правила так, чтобы они у нас от зубов отскакивали.
enus_ruru_60.mp3	Он очень начитанный молодой человек. Теория у него от зубов отскакивает, но с практикой пока туга.
enus_ruru_61.mp3	Азе летного мастерства молодой Чкалов осваивал в авиационной школе воздушной стрельбы и бомбометания под Серпуховым, сокращенно называвшейся стрельбомом.
enus_ruru_62.mp3	Все эти книги написаны доступным языком, чтобы любой начинающий кинематографист мог освоить озы интересной специальности.
enus_ruru_63.mp3	А цыганка в ответ говорит:  Дай ручку позолочу, дорогой, всю правду расскажу.
enus_ruru_64.mp3	 Меня попросили позолотить ручку, я растерялась и быстро выскочила из комнаты,  пожаловалась девушка.
enus_ruru_65.mp3	Хотела я показать ей, где раки зимуют, а тут, как на зло, Иванович зашел.
enus_ruru_66.mp3	Я не на шутку рассердилась, и у меня сразу же возникло желание показать им всем, где раки зимуют.
enus_ruru_67.mp3	Бюджет страны лопался от гонки вооружений, а в штабах царила атмосфера пира во время чумы.
enus_ruru_68.mp3	росла и ширилась великая русская смута, а в столице Пирм во время чумы кипели политические дебаты.
enus_ruru_69.mp3	Человек десять сидели за столиками, а у стойки только одинокая красивая девушка, которая была изрядно под мухой.
enus_ruru_70.mp3	время от времени дед возвращался домой под шофе но в таком случае утром ему была обеспечена длительная лекция о вреде спиртного в приклонном возрасте
enus_ruru_71.mp3	может она пьяная решила под чафе позвонить или написать бывшему парню но перепутала а какие еще могут быть объяснения
enus_ruru_72.mp3	Ребята восторженно переглянулись и решили, что эти билеты просто подарок судьбы.
enus_ruru_73.mp3	При ближайшем рассмотрении сидений дома всей семьей оказывается подарком судьбы.
enus_ruru_74.mp3	варя подумала что этот тихий и спокойный городок идеальное место для жизни но со временем выяснилось что в тихом муте черти водятся в городе было много своих проблем
enus_ruru_75.mp3	спокойное и тихое, говоришь. Это ты ее плохо знаешь. Как говорится, в тихом муте.
enus_ruru_76.mp3	в тихом омуте сам знаешь кто водится. Внешность и манеры поведения человека бывают обманчивы.
enus_ruru_77.mp3	уволившись с прежней работы и не имея возможности найти новую валентин оказался между небом и землей его перспективы и дальнейшие возможности трудоустройства казались туманными
enus_ruru_78.mp3	Они были готовы на что угодно, лишь бы перестать болтаться между небом и землей. Кому понравится такая жизнь без жилья и работы?
enus_ruru_79.mp3	что тебе все время не нравится. Условия отличные. Тепло, светло и мухи не кусают. Живи да радуйся.
enus_ruru_80.mp3	Дети совершенно не хотели возвращаться домой. А куда им было спешить? Им и там было неплохо: тепло, светло и мухи не кусают.
enus_ruru_81.mp3	всегда просите предоставить вам документальное подтверждение сказал юрист может оказаться что вам просто вешают лапшу на уши
enus_ruru_82.mp3	Во время выборов политики часто пытаются вешать лапшу на уши избирателей, обещая им то, что не могут выполнить.
enus_ruru_83.mp3	Как только мы высказали свои намерения, конкуренты быстро поняли, что мы собираемся захватить часть их рынка и попытаться взять их в тиски.
enus_ruru_84.mp3	Кредиторы взяли компанию в тиски, требуя немедленного погашения долга.
enus_ruru_85.mp3	она решила взять волю в кулак и начать учить новый язык несмотря на сложности с которыми она неоднократно сталкивалась на пути обучения
enus_ruru_86.mp3	Ольга взяла волю в кулак и пошла на интервью, несмотря на свой страх.
enus_ruru_87.mp3	на концерте певец исполнил такую красивую песню что она взяла за душу всех присутствующих в зале никто не остался равнодушным
enus_ruru_88.mp3	История о бедной семье, живущей на улице, взяла ее за душу, и она решила оказать посильную помощь.
enus_ruru_89.mp3	Книжная жизнь столицы не то чтобы бьет ключом, но и не стоит на месте.
enus_ruru_90.mp3	это только кажется что за пределами третьего транспортного кольца жизнь останавливается пусть она и не бьет ключом как в центре но уж сонным царством ее сегодня не назовешь
enus_ruru_91.mp3	Ведьма уж точно не казалась божьим одуванчиком, но и на уродливую, вредную коргу не тянула.
enus_ruru_92.mp3	 Бабушка Божия, дуванчик, а сколько в ней злости?
enus_ruru_93.mp3	 Я бы не хотел подложить свинью своему лучшему другу,  сказал Марк.  Не люблю подводить людей.
enus_ruru_94.mp3	Есть такие друзья-приятели, которые по техе ради всегда ищут случая подложить другу свинью, думая, что это смешно.
enus_ruru_95.mp3	Не следует считать это происшествие чем-то из ряда вон выходящим. В нашей конторе такое, увы, случается достаточно регулярно.
enus_ruru_96.mp3	пока руководство компании пребывало в блаженной прострации эта шальная новость стремительно распространялась среди сотрудников передаваясь из уст в уста
enus_ruru_97.mp3	Переходя из уст в уста, коварно и бесчестно, крылатым змеем клевета носилась повсеместно.
enus_ruru_98.mp3	первый блин вышел комом и наш старший инженер сергей соколов сразу засел писать объяснительные для руководства почему и как долгожданный запуск системы завершился таким провалом
enus_ruru_99.mp3	 Ладно, будем считать первый блин комом, а в следующий раз я наберу столько припасов, на сколько денег хватит.
enus_ruru_100.mp3	Он же был сыном самого главы местного крайкама, первый парень на деревне.
enus_ruru_101.mp3	мне было пять лет когда я сам научился играть на маленькой гармошке отчего невольно стал первым парнем на деревне поскольку других музыкантов в округе не было
enus_ruru_102.mp3	Что может быть лучше, чем прогулки по лесу в баби лета? Последние теплые дёнки перед холодной дождливой осенью.
enus_ruru_103.mp3	 Вот эта погода,  сказал Михаил.  Настоящее бадье лето. Интересно, надолго ли?
enus_ruru_104.mp3	но что поделать приходится вертеться как белка в колесе и мечтать о полноценном сне в своей квартире
enus_ruru_105.mp3	при современном бешенном темпе жизни многие мамы и папы вынужденные вертеться как белка в колесе не понимают одной простой вещи
enus_ruru_106.mp3	Я знаю, что у каждого вертится на языке множество вопросов.
enus_ruru_107.mp3	А ваш отец, он, сложный вопрос вертелся на языке, она боялась причинить боль, обидеть.
enus_ruru_108.mp3	И будут у вас детки, вот увидите. Не вешайте нос.
enus_ruru_109.mp3	Не надо вешать нос. Пара недель разлуки вашим отношениям не повредит.
enus_ruru_110.mp3	Сразу оговорюсь, что не хочу и не буду бросать камни в огород нашей медицины, врачей и методов лечения.
enus_ruru_111.mp3	не удержусь от того, чтобы бросить камень в огород журналистской братства. Их перья к этому явлению приложились основательно
enus_ruru_112.mp3	Нужно быть осторожным и очень внимательным, чтобы не попасться на удочку мошенников.
enus_ruru_113.mp3	Спекулянты ловко орудуют на этом рынке. К сожалению, мы тоже попали на их худочку.
enus_ruru_114.mp3	Хотела я показать ей, где раки зимуют, а тут, как на зло, Иванович зашел.
enus_ruru_115.mp3	Я не на шутку рассердилась, и у меня сразу же возникло желание показать им всем, где раки зимуют.
enus_ruru_116.mp3	В ответ на этот поступок хозяин дома пообещал показать непрошенному гостю Кускину мать.
enus_ruru_117.mp3	Но, положив руку на сердце, нужно отметить: подвиги своего героя он чуть ли не высасывал из пальца.
enus_ruru_118.mp3	Даже сейчас, положив руку на сердце, могу честно признаться: ну, какой из меня руководитель?
enus_ruru_119.mp3	Я так боялся получить на орехи, что постарался побыстрее скрыться с глаз.
enus_ruru_120.mp3	Несмотря на все свои старания и вовремя сделанную контрольную, я все равно получил на орехи от учителя.
enus_ruru_121.mp3	Если это действительно твой человек, тебе будет казаться, что он читает твои мысли и понимает с полуслова.
enus_ruru_122.mp3	можно легко попасть в просак и выставить себя глупым человеком если много говорить по теме, которая не совсем вам знакома
enus_ruru_123.mp3	он забыл о сроке подачи заявки на конкурс и только за несколько дней до его окончания понял что попал в просак и уже ничего не успеет сделать
enus_ruru_124.mp3	Нужно быть осторожным и очень внимательным, чтобы не попасться на удочку мошенников.
enus_ruru_125.mp3	спекулянты ловко орудуют на этом рынке. К сожалению, мы тоже попали на их удочку.
enus_ruru_126.mp3	Вся эта история попахивала неприятностями, но соблазн участвовать в розыгрыше был слишком велик.
enus_ruru_127.mp3	Обстановка на работе попахивала неприятностями, и я боялся, что в итоге меня уволят.
enus_ruru_128.mp3	Слыша фразу После дождечка в четверг, понимаю, что надеется мне ни на что ни в скорой, ни в долгосрочной перспективе.
enus_ruru_129.mp3	пригласив наташку на свидание я затавив дыхание боялся получить отказ а она рассмеялась и выпалила после дождечка в четверг
enus_ruru_130.mp3	Наверное, для меня это была последняя капля. Мне захотелось поскорее прекратить эти отношения.
enus_ruru_131.mp3	Левин раскритиковал его книгу. После этого они рассорились в пух и прах.
enus_ruru_132.mp3	Папа был на пределе, и я боялся, чтобы родители не рассорились в пух и прах.
enus_ruru_133.mp3	Не стоит посыпать голову пеплом, пока еще есть надежда исправить ситуацию.
enus_ruru_134.mp3	в своей жизни анна сталкивалась с такими ситуациями когда впору было посыпать голову пеплом но она снова находила в себе силы продолжать борьбу
enus_ruru_135.mp3	Он уже было взял ручку, но, почувствовав неладное, снова отложил ее и не стал подписывать договор.
enus_ruru_136.mp3	Порой предоставить подростка самому себе не хуже вариант это поможет ему разобраться в своих приоритетах
enus_ruru_137.mp3	из за халатности медсестер больные в палате были предоставлены сами себе даже капельницу снять было некому
enus_ruru_138.mp3	Личинки майского жука присекали на корню мое желание выращивать клубнику.
enus_ruru_139.mp3	Наилучший способ не дать эпидемии распространиться  это присечь ее на корню.
enus_ruru_140.mp3	Чтобы не упасть в грязь лицом, ей пришлось напрячься и прийти на этот праздник при полном параде.
enus_ruru_141.mp3	Это был необычный день. Несмотря на тяготы своего положения, он хотел быть при полном параде.
enus_ruru_142.mp3	Если не придираться к мелочам, то работа выполнена на отлично.
enus_ruru_143.mp3	И как можно получить хорошую оценку, когда учитель придирается к мелочам? Ему все время что-то не нравится.
enus_ruru_144.mp3	эти видеозаписи помогут тебе прижать к стене этого лгуна и вывести его на чистую воду
enus_ruru_145.mp3	Он еще пытался сопротивляться, но был прижат к стене; доказательства его неправоты были неоспоримыми.
enus_ruru_146.mp3	Истерика у Татьяны длилась недолго. Крепкие объятия матери помогли ей быстро прийти в себя.
enus_ruru_147.mp3	Выпив стакан воды, девушка быстро пришла в себя и стала спешно рассказывать о случившемся.
enus_ruru_148.mp3	В фильме Побег из Шевченко у Энди был призрачный шанс бежать из тюрьмы, но он смог им воспользоваться.
enus_ruru_149.mp3	У Николая был призрачный шанс сдать экзамен, но ему повезло: он вытащил единственный билет, который учил.
enus_ruru_150.mp3	На совете директоров было принято решение, что новый сотрудник пришелся не ко двору, так как не соответствовал установленным требованиям.
enus_ruru_151.mp3	Почему степку не взяли в команду?  Да он пришел, сынико, дворе. Не подходит он нам, играть не умеет.
enus_ruru_152.mp3	Разумеется, не все, что я узнал от свидетелей, следовало принимать за чистую монету.
enus_ruru_153.mp3	но в том возрасте ты еще не знала что такое самооценка и поэтому все комплименты принимала за чистую монету и думала что ты действительно единственное в своем роде и неповторимое
enus_ruru_154.mp3	болельщики будут благодарны за информацию о ключевых игроках спонсоры оценят рекламные возможности а клуб сможет продвигать запланированные мероприятия подогревая интерес публики к ним
enus_ruru_155.mp3	Необходимо постоянно подогревать интерес вашего собеседника, чтобы его внимание ни на минуту не ослабевало.
enus_ruru_156.mp3	и сотрудники вновь начали рассказывать о причинах сорванных сроков, сложных условиях работы и несправедливом отношении. В общем, снова завели сказку про белого бычка.
enus_ruru_157.mp3	может он все же исправился снова спросила алена но если честно мне эта сказка про белого бычка уже порядком поднадоела
enus_ruru_158.mp3	сидоровы без боя не сдаются упрямо сказал васка и продолжил ковыряться с платой надеясь найти сгоревшую микросхему
enus_ruru_159.mp3	этот экзамен был явно сложнее чем ожидалось петров встретилось много непонятных вопросов но такие как он без боя не сдаются и наш друг старался изо всех сил сдав в итоге этот злосчастный экзамен пусть и с минимальным проходным баллом
enus_ruru_160.mp3	Он слишком много брал на себя, и жена всегда его ругала:  Алеша, ну зачем ты так? Тебе что больше всех надо?
enus_ruru_161.mp3	Иной раз мы слишком много берем на себя и слишком многого ожидаем от этих своих усилий.
enus_ruru_162.mp3	его ленивая сестра всю жизнь сидит на шее у родителей и никак не хочет сама работать желая получать все в своей жизни бесплатно
enus_ruru_163.mp3	Государство по-прежнему сидело на шее у мужиков, выбивая из них выкупные платежи, которые представляли собой самый, что не наесть прямой налог.
enus_ruru_164.mp3	с первого взгляда казалось что это милейший человек который мухи не обидит но в тихом мути черти водится спустя несколько месяцев он показал себя во всей своей красоте
enus_ruru_165.mp3	варя подумала что этот тихий и спокойный городок идеальное место для жизни но со временем выяснилось что в тихом муте черти водятся в городе было много своих проблем
enus_ruru_166.mp3	 Спокойное и тихое, говоришь? Это ты ее плохо знаешь. Как говорят, в тихом муте.
enus_ruru_167.mp3	в тихом омуте сам знаешь кто водится внешность и манера поведения человека бывают обманчивы
enus_ruru_168.mp3	всегда просите предоставить вам документальное подтверждение сказал юрист может оказаться что вам просто вешают лопшу на уши
enus_ruru_169.mp3	Во время выборов политики часто пытаются вешать лапшу на уши избирателей, обещая им то, что не могут выполнить.
enus_ruru_170.mp3	Как только мы высказали свои намерения, конкуренты быстро поняли, что мы собираемся захватить часть их рынка и попытаться взять их в тиски.
enus_ruru_171.mp3	Кредиторы взяли компанию в тиски, требуя немедленного погашения долга.
enus_ruru_172.mp3	она решила взять волю в кулак и начать учить новый язык несмотря на сложности с которыми она неоднократно сталкивалась на пути обучения
enus_ruru_173.mp3	Ольга взяла волю в кулак и пошла на интервью, несмотря на свой страх.
enus_ruru_174.mp3	на концерте певец исполнил такую красивую песню что она взяла за душу всех присутствующих в зале никто не остался равнодушным
enus_ruru_175.mp3	История о бедной семье, живущей на улице, взяла ее за душу, и она решила оказать посильную помощь.
enus_ruru_176.mp3	васька сидоров был доносчиком как разнюхает что кто нибудь из нас где то накасячил так сразу берет на карандаш а потом строчит жалобы в портком
enus_ruru_177.mp3	все эти наставления подробно изложенные в докторской монографии нашего многоуважаемого Георгия Альбертовича Горячевского будет полезно взять на карандаш любому аналитику
enus_ruru_178.mp3	Вопросы экономического роста не должны приводить к ухудшению качества жизни населения. Важно найти баланс, чтобы и волки были сыты, и овцы остались целы.
enus_ruru_179.mp3	Когда в мечтах и волки сыты, и овцы целы, это очевидное противоречие.
enus_ruru_180.mp3	Человек может надумать себе что угодно, а логические знания всегда отстают от интуитивных знаний.
enus_ruru_181.mp3	но это не свидание, а то надумаешь себе сейчас. Считай это дружеской встречей и не более.
enus_ruru_182.mp3	демократы из стран третьего мира выполняют всю черновую работу а реальные хозяева получают чистую прибыль
enus_ruru_183.mp3	так теряясь в лучах славы других процессоров интел восьмиразрядный предк выполнял черновую работу в персональных компьютерах
enus_ruru_184.mp3	Пассажиры поезда представляли сливки высшего общества и делового мира древней столицы
enus_ruru_185.mp3	Сам ресторан был очень дорогим. Там присутствовали только сливки высшего общества.
enus_ruru_186.mp3	День сгорал, как свеча. Приближались сумерки.
enus_ruru_187.mp3	Жалька та любовь, которую нужно держать в узде!  воскликнула она.  Я такой любви не хочу.
enus_ruru_188.mp3	 Прямо сейчас,  сказал он, пытаясь держать в узде свою злость,  мне нужны только деньги, много денег.
enus_ruru_189.mp3	организм человека во время эпидемии гриппа может долго держать защиту но в один прекрасный день мы все таки подхватываем вирус если накануне перегрузились понервничали или не выспались
enus_ruru_190.mp3	будучи кристально честным человеком он всегда поступал по совести но в той обители зла где он работал ему постоянно приходилось держать круговую оборону
enus_ruru_191.mp3	Еще один маркер хороших взаимоотношений с командой  это ваше умение держать слово.
enus_ruru_192.mp3	в странице его книги поведают как держали удары судьбы русские самоучки предприниматели выбиваясь в купцы первой гильдии и превращаясь вокруг нефтеного промысла
enus_ruru_193.mp3	Конечно же, можно говорить о волевых качествах личности спортсмена, силе духа, умении концентрироваться, способности держать удар.
enus_ruru_194.mp3	с этим человеком постоянно приходилось держать ухо востро ожидая, что он совершит какой нибудь неожиданный поступок
enus_ruru_195.mp3	Я и сам знал, что это не к добру, хуже не бывает приметы, и здорово перепугался. Просто душа в пятки ушла.
enus_ruru_196.mp3	У меня от увиденного душа в пятке ушла. Теперь я понимала это выражение и на себе ощутила, как это бывает.
enus_ruru_197.mp3	в детдоме все моральные качества юного человека душили в зародыше
enus_ruru_198.mp3	он всегда был консервативен в своих взглядах и часто заявлял, что любое инакомыслие нужно непременно душить в зародыше
enus_ruru_199.mp3	Мне не нравится, как он замыливает глаза, когда я спрашиваю о его планах на выходные.
enus_ruru_200.mp3	Мой начальник пытался замылить мне глаза, чтобы скрыть свою ошибку.
enus_ruru_201.mp3	Я знаю этого человека очень хорошо, зуб даю, он не лжет.
enus_ruru_202.mp3	если он опоздает еще раз то зуб даю что неприятностей не избежать его уже много раз предупреждали о том что опоздания недопустимы
enus_ruru_203.mp3	Она не из робкого десятка и всегда готова идти в атаку, независимо от того, права она или нет.
enus_ruru_204.mp3	мои друзья очень хвалят свой новый район и это понятно ведь каждый кулик свое болото хвалит
enus_ruru_205.mp3	я считаю что наша компания самая лучшая конечно ведь каждый кулик свое болото хвалит хотя я тоже считаю что тебе повезло с работой
enus_ruru_206.mp3	После того как изменилась политическая обстановка, новые партии начали вылазить как грибы после дождя.
enus_ruru_207.mp3	Торговые центры в нашем городе растут как грибы после дождя, их с каждым месяцем становится все больше.
enus_ruru_208.mp3	Услышав громкий взрыв, Ирина поняла, что пора брать ноги в руки и бежать куда глаза глядят.
enus_ruru_209.mp3	если хочешь продолжать здесь работать, ноги в руки и бегом к начальству писать объяснительную.
enus_ruru_210.mp3	Красная нить в этом романе  это любовная история, которая связывает главных героев на протяжении всей книги.
enus_ruru_211.mp3	Красная нить, связывающая жизнь двух людей, оказалась сильнее всех разногласий и трудностей.
enus_ruru_212.mp3	хотя современная молодежь уже не помнит значения этого праздника для моего поколения эта дата навсегда останется красным днем календаря
enus_ruru_213.mp3	В этом году впервые этот день был объявлен нерабочим. Он стал красным днем календаря.
enus_ruru_214.mp3	Он работал на износ до седьмого пота, но никакой благодарности за свою кровавую работу не получал.
enus_ruru_215.mp3	Я был бы признателен, если бы кто-то сделал за меня эту ужасную кровавую работу. Но не думаю, что желающие найдутся.
enus_ruru_216.mp3	Родители составили длинный список дел, которые кровь из носу нужно успеть сделать до холодов.
enus_ruru_217.mp3	мне кровь из носу нужна информация об этом человеке иначе я пропал взмолился павел
enus_ruru_218.mp3	Кто рано встает, тому Бог подает. Этот принцип помогает мне каждый день с самого утра браться за важные дела.
enus_ruru_219.mp3	Слова: Кто рано встает, тому Бог подает напоминали ей, что трудолюбие и настойчивость награждаются успехом.
enus_ruru_220.mp3	Она просто купается в роскоши, путешествует на частном самолете, живет в огромной вилле на берегу моря и ни в чем себе не отказывает.
enus_ruru_221.mp3	Очень грустно, что в этом мире единицы купаются в роскоши, а большинство вынуждено жить в нищете.
enus_ruru_222.mp3	Некоторые люди любят лезть не в свое дело, что зачастую приводит к ненужным проблемам и конфликтам.
enus_ruru_223.mp3	Мой коллега ужасно меня раздражает. Он постоянно лезет не в свое дело и пытается контролировать мою работу.
enus_ruru_224.mp3	в нашем обществе принято считать что интересы отдельного взятого человека это что то несущественное главное интересы общественные как говорят лес рубят щепки летают
enus_ruru_225.mp3	Система приучила его к тому, что человек ничего не значит. Лес рубят, щепки летают. Кажется, изменить это мышление уже невозможно.
enus_ruru_226.mp3	Мой друг считает, что он достойный лучшей работы, но я говорю ему, что лучше синиться в руках, чем журавль в небе, поэтому лучше ценить то, что он уже имеет.
enus_ruru_227.mp3	конечно когда то я мечтал о большом доме и роскошной жизни но в итоге я понял что лучше иметь сеницу в руках чем журавля в небе и что не стоит стремиться к недостижимому
enus_ruru_228.mp3	местные жители испугавшись перспективы оказаться между молотом и на ковальней стали уезжать кто куда кто в другие области кто за границу
enus_ruru_229.mp3	уволившись с прежней работы и не имея возможности найти новую валентин оказался между небом и землей его перспективы и дальнейшие возможности трудоустройства казались туманными
enus_ruru_230.mp3	что тебе все время не нравится. Условия отличные. Тепло, светло и мухи не кусают. Живи да радуйся.
enus_ruru_231.mp3	Дети совершенно не хотели возвращаться домой. А куда им было спешить? Им и там было неплохо: тепло, светло и мухи не кусают.
enus_ruru_232.mp3	как ни велико побуждение окончательно сжечь мосты побеждает желание увидеть их лица когда я предстану перед своей родной раздетой как принцесса под ручку со своим неотразимым избранником
enus_ruru_233.mp3	Он решил убить двух зайцев сразу, предоставить новый полезный для общества продукт и заработать на этом.
enus_ruru_234.mp3	я решил купить новый компьютер чтобы более эффективно работать и играть в компьютерные игры в свободное время так я убил двух зайцев одним выстрелом
enus_ruru_235.mp3	Этот идиот будет стоять на своем, пока ему кишки не выпустят.
enus_ruru_236.mp3	 По моему самое время развязать мне руки, сестрица. Мы сейчас в одной лодке. Эти ребята выпустят кишки нам обоим.
enus_ruru_237.mp3	Я 22-го года преподавал литературу в школе и прекрасно понимаю, что все романы прочесть невозможно. А если школьник и попытается это сделать, то получится галопом по европам.
enus_ruru_238.mp3	Гумбольдт промчался по Уралу, как говорят, галопом по европам.
enus_ruru_239.mp3	Раньше гвоздём программы считался дрессировщик тигров, но работа поглотила беднягу целиком и пришлось сделать ставку на волшебника.
enus_ruru_240.mp3	лет десять назад я сказала бы что где наше не пропадало а сейчас скажу что это самая грязная сложная опасная профессия для любого человека
enus_ruru_241.mp3	черт с ним где наше не пропадало анатолий иванович уверил меня что вы можете всё
enus_ruru_242.mp3	Помолчи, у меня голова и без того кругом, а у тебя привычка говорить под руку.
enus_ruru_243.mp3	Не надо говорить мне под руку.  Я сейчас занят. Не видишь?
enus_ruru_244.mp3	по натуре он типичная деловая колбаса
enus_ruru_245.mp3	танцевать не хочешь песни не поешь не веселишься деловая колбаса
enus_ruru_246.mp3	Вот человек, у которого слишком длинный язык. Он постоянно болтает и распускает слухи.
enus_ruru_247.mp3	 Маша, у тебя длинный язык, перестань болтать.
enus_ruru_248.mp3	что бы там ни говорили сторонники и противники цифровых пространств они могут спорить до хрипоты а мне чужое мнение уже не важно
enus_ruru_249.mp3	можно спорить с этим до бесконечности до хрипоты доказывать что все это выдумки что тебя создали твои родители но ведь от этого правда не изменится
